%%%%%%%%%%
%  %  GGG%
%  %p%%GG%
% p%  GGG%
%  % %%%P%
%R   % R %
% %% %   %
%    % %%%
%S      p%
%%%%%%%%%%
