%%%%%%%%%%%%%%%%%%%%%%%%%%%
%p       %  R   %p  G%GGGG%
%%%%  %%%%        R% %    %
%%%%   R %      %    %    %
%%%%            %      P  %
%R     %  %%%%%%%%%%%%   %%
%p     %%      %  pR     p%
%%%%%%%%%%%    %    %%%%  %
%         %S              %
%%%%%%%%%%%%%%%%%%%%%%%%%%%
